Enemy Spawn Maze
//spawn point (room, y, x)
0 1 1
ROOMSTART
0 0 0 0 0 0 0 0 0 0 0 0 0 0
0 1 1 0 0 0 0 0 0 0 0 0 0 0
0 0 1 0 0 0 0 0 0 0 0 0 0 0
1 1 1 0 0 0 0 0 0 0 0 0 0 0
0 0 0 0 0 0 0 0 0 0 0 0 0 0
0 1 1 0 0 0 0 0 0 0 0 0 0 0
1 1 1 0 0 0 0 0 0 0 0 0 0 0
1 1 0 0 0 0 0 0 0 0 0 0 0 0
1 0 0 0 0 0 0 0 0 0 0 0 0 0
0 0 0 0 0 0 0 0 0 0 0 0 0 0
2 2 2 2 1 1 1 1 1 1 1 1 0 1
2 0 0 2 1 0 0 0 0 0 0 0 0 1
2 2 0 2 1 0 1 1 1 1 1 0 1 1
0 0 0 2 1 0 0 0 0 1 0 0 0 1
2 2 0 2 1 0 1 0 0 1 0 0 0 1
1 0 0 0 0 0 1 0 0 1 0 0 0 1
1 0 1 1 1 1 1 0 1 1 1 0 1 1
1 0 1 0 0 0 0 0 0 1 0 0 0 1
1 0 0 0 1 0 0 0 0 0 0 0 0 1
1 1 1 1 1 1 1 1 1 1 1 1 1 1
BGM song02
ENEMYSPAWN 4 11 0
ENEMYSPAWN 7 6 0
ENEMYSPAWN 4 8 0
WALL 3 1
ENEMYSPAWN 7 10 0
WALL 0 2
ENEMYSPAWN 1 9 0
ROOMEND
ROOMSTART
0 0 0 0 0 0 0 0 0 0 0 0 0 0
0 0 0 0 0 0 0 0 0 1 1 1 0 0
0 0 0 0 1 1 0 0 1 1 0 1 1 0
0 0 4 1 1 1 1 1 1 0 0 1 1 1
0 0 0 0 1 1 0 0 1 1 0 1 1 0
0 0 0 0 0 1 0 0 0 1 1 1 0 0
0 0 0 0 0 0 0 0 0 0 0 0 0 0
0 0 0 0 1 1 0 0 0 0 0 0 0 0
0 0 0 0 0 0 0 0 0 0 0 0 0 0
0 0 1 0 1 0 0 0 0 0 0 0 0 0
2 2 2 2 2 2 2 2 2 2 2 2 2 2
2 2 2 2 3 2 2 2 2 0 0 0 2 2
2 2 2 2 0 0 2 2 0 0 2 0 0 2
2 2 0 0 0 0 0 0 0 2 2 0 0 0
0 2 2 2 0 0 2 2 0 0 2 0 0 2
1 0 2 2 2 0 2 2 2 0 0 0 2 2
1 1 0 1 0 0 2 2 2 2 2 2 2 2
0 0 1 1 0 0 1 0 0 1 0 1 1 1
0 1 0 0 0 0 1 0 1 0 1 1 1 1
1 1 0 0 0 1 0 1 0 1 0 0 1 1
BGM song02
WALL 1 0
ENEMYSPAWN 3 8 0
TELE 1 4 3 9 3
WALL 2 4
ROOMEND
ROOMSTART
0 0 0 0 0 0 0 0 0 0 0 0 0 0
0 0 0 0 0 0 0 0 0 0 0 0 0 0
0 0 0 0 0 0 0 0 0 0 0 0 0 0
0 0 0 1 1 1 0 0 1 1 0 0 0 0
0 0 0 1 1 0 1 1 1 0 0 0 0 0
0 0 0 0 1 0 0 1 0 0 0 0 0 0
0 0 0 0 0 1 1 0 0 0 0 0 0 0
0 0 0 0 1 0 0 1 1 0 0 0 0 0
0 0 0 0 1 0 1 0 0 0 0 0 0 0
0 0 0 0 0 1 0 0 0 0 0 0 0 0
2 2 2 2 2 2 2 2 2 2 2 2 2 2
2 2 2 2 2 2 2 2 2 2 2 2 2 2
2 2 2 2 3 2 2 1 1 1 2 2 2 2
2 2 2 0 0 0 1 1 0 0 1 1 1 1
2 2 1 0 0 0 0 0 0 0 0 1 1 1
2 2 0 0 0 0 0 1 0 1 0 0 1 1
2 2 1 0 0 0 0 0 1 0 0 0 0 1
2 2 1 1 0 1 0 0 0 0 0 1 0 1
2 2 2 1 1 1 0 0 1 0 1 1 0 1
2 2 2 2 1 1 1 1 1 1 1 1 0 1
BGM song02
WALL 2 0
TELE 2 4 3 9 11
ENEMYSPAWN 7 8 0
ENEMYSPAWN 5 4 0
ROOMEND
ROOMSTART
0 0 0 0 0 0 0 0 0 0 0 0 0 0
0 0 0 0 0 0 1 1 0 0 0 0 0 0
0 0 1 0 1 1 0 1 1 1 1 1 0 0
0 1 1 1 1 1 1 1 1 1 1 1 1 0
0 0 1 1 1 0 1 1 1 1 0 0 1 0
0 0 1 1 1 0 0 1 1 1 0 1 1 0
0 0 1 1 1 1 1 1 0 1 1 1 1 0
0 1 1 1 1 1 0 0 0 1 1 1 1 0
0 0 0 1 0 0 0 0 0 0 0 1 0 0
0 0 0 1 0 0 0 0 0 0 0 1 0 0
2 2 2 2 2 2 2 2 2 2 2 2 2 2
2 2 2 2 2 2 0 0 2 2 2 2 2 2
2 2 0 2 0 0 2 0 0 0 0 0 2 2
2 0 0 0 0 0 0 0 0 0 0 0 0 2
2 2 0 0 0 2 0 0 0 0 2 2 0 2
2 2 0 0 0 2 2 0 0 0 2 0 0 2
2 2 0 0 0 0 0 0 2 0 0 0 0 2
2 0 0 0 0 0 2 2 2 0 0 0 0 2
2 2 2 0 2 2 2 2 2 2 2 0 2 2
2 2 2 0 2 2 2 2 2 2 2 0 2 2
BGM song04
TELE 10 3 1 2 4
TELE 10 11 2 3 4
ENEMYSPAWN 4 7 0
ROOMEND
ROOMSTART
0 0 0 1 0 0 0 0 0 0 0 1 0 0
0 1 0 1 0 0 0 0 1 1 0 0 0 3
0 1 1 0 1 0 0 0 0 1 0 0 0 3
0 0 0 0 0 1 0 1 0 0 0 2 3 3
0 1 4 1 0 0 0 0 2 2 2 2 3 3
4 1 4 4 2 2 2 2 2 2 2 2 3 3
0 0 2 2 2 2 2 2 2 2 3 3 3 3
0 2 2 2 2 2 2 3 3 3 3 3 3 3
0 2 2 2 2 3 3 3 3 3 3 3 3 3
0 2 2 3 3 3 3 3 3 3 3 3 3 3
1 1 0 0 0 1 0 1 0 1 1 1 0 1
1 0 0 0 0 0 1 0 1 0 1 0 1 0
1 0 0 0 0 0 0 1 1 1 1 1 0 0
1 1 0 1 0 0 0 0 1 1 1 0 0 0
1 0 0 0 0 0 0 1 0 0 0 1 0 0
0 0 0 0 0 0 0 0 4 0 0 0 0 0
1 1 0 0 0 1 0 0 0 0 0 0 0 0
1 0 0 0 0 0 0 0 0 0 0 0 0 0
1 0 0 0 0 0 0 0 1 1 0 0 0 0
1 0 0 0 0 0 0 0 1 0 0 0 0 0
BGM song02
WALL 0 1
ENEMYSPAWN 7 4 0
WALL 3 5
ROOMEND
ROOMSTART
0 0 0 0 0 0 0 0 0 0 0 0 0 0
0 0 0 1 0 0 0 1 0 0 0 0 0 0
0 0 3 3 3 0 0 1 1 0 1 0 0 0
0 3 3 0 3 3 0 0 4 1 0 1 1 0
1 3 1 4 0 3 0 1 0 4 4 1 0 0
0 3 4 1 1 3 1 4 4 1 4 1 4 4
0 3 4 1 3 3 1 4 1 4 3 1 4 0
3 3 3 4 3 1 4 4 0 3 3 4 0 0
3 3 1 4 4 4 1 1 4 4 3 0 3 3
3 1 1 3 3 0 0 4 1 0 4 3 3 3
2 2 2 0 2 2 2 2 2 2 2 2 2 1
2 2 1 0 2 2 2 0 2 3 2 2 1 0
2 2 0 0 0 2 1 0 0 0 0 1 1 1
2 0 0 0 0 0 1 0 0 0 0 0 0 1
0 0 0 4 0 0 0 0 1 0 0 0 0 1
1 0 0 0 0 0 0 0 0 0 0 0 0 0
1 0 0 0 0 0 0 0 0 0 0 0 0 1
0 0 0 0 0 0 0 0 1 0 0 0 1 1
0 0 0 0 0 0 0 1 0 0 0 0 0 0
0 1 1 0 0 1 1 1 0 0 0 0 0 0
BGM song02
WALL 1 4
ENEMYSPAWN 8 4 0
ENEMYSPAWN 5 7 0
TELE 1 9 1 3 2
ROOMEND